11111111111111111111111111111111111
1C000C011000000C00000C0000000110001
1010001C001111001010000101011110001
10110110101011111011111101011100111
10100100101010100CC0000101011100111
1010010C1010101111100001010111001E1
1P0000000C00C000CCC0000110000000C01
11111111111111111111111111111111111