1111111111111111111111111111111111111
100000000P10000C100000000C100000101C1
1010111111101010111011101110101010101
1010001000101010001000101000101000001
1010101110101011101011111010111110111
1C1010000000101000000010001C1C0010001
1111111110101111101011101111111011111
1000001000100000101010000010001010001
1010101110111010111110111110101010101
10101C10000010100C10100000101010001C1
1011111010101111111010111111101010111
100000001010100010000000100C10001C101
1111101111111011111110101011111011101
1C000000000C1000100010100000100000001
1010111111111010101111101110111011101
1010100000000010000000000C1010001C001
1110111011101110111110101110101010111
10001000001010001010001000100010101E1
1010C0101C001010100000100C10000010001
1111111111111111111111111111111111111